▓▓▓▓▓▓▓▓▓▓ߛ▓▓▓▓▓▓▓▓▓▓▓▓▓▓▓▓▓▓ߛ▓▓▓▓▓▓▓▓▓▓▓
▓▆    ▆▆☎▆    ▆▓    ▓   ▆▆▆▆   ▆   ✿▓▆▆▆▓
▓▆             ▓    ▓                  ▆▓
▓▆    ▆▆      Ր▓    ▓                   ▓
▓▆▆            ▓    ▓   ▆▆▆▆   ▆ↈ ▆▆▆⏰  ▓
▓  ߛ▆♨▆        ⟧        ▓▓▓▓▓▓▓▓▓▓▓▓▓▓▓▓▓
▓▓▓▓▓▓▓▓▓▓▓▓▓▓▓▓        ▓▓▓▓   ߛߛߛߛ    ▓▓
▓⍍ ▓▓▓♫▋□▋     ▓                        ▓
▓⍍ ▓▓▓♫♫♫♫♫    ▓                        ▓
▓⍍     ♫♫♫ ♫   ▓                        ▓
▓⍍         ♫♫  ▓                        ▓
▓⍍          ♫♫♫▓                 ⚿      ▓
▓⍍           ♫ ▓                ▓▓▓     ▓
▓⍍            ♫⟧               ▓▓▓▓▓ ❽  ▓
▓▓▓▓▓▓▓▓▓▓▓▓▓▓▓▓⛔ ▓▓▓▓▓▓▓▓▓▓▓▓▓▓▓▓▓▓▓▓▓▓▓
▓☘இ    இ     இ        ☘☘இ     இ     இ☘  ▓
▓   இ     ☘☘       இ       இ     இ      ▓
▓▓▓▓▓▓▓▓▓▓▓▓▓▓▓▓▓▓▓▓▓▓▓▓▓▓▓▓▓▓▓▓▓▓▓▓▓▓▓▓▓
